{
    "WIDTH"         : 30,
    "HEIGHT"        : 30,
    "START_POS"     : [10,10],
    "APPLE"         : ".\\ResourcesConfigs\\Apls\\rom.png",
    "SNAKE_HEAD"    : ".\\ResourcesConfigs\\Snake\\head2.png",
    "SNAKE_TORSO"   : ".\\ResourcesConfigs\\Snake\\body1.png",
    "FLOR_PATH"     : ".\\ResourcesConfigs\\Flor\\sand.png",
    "WALL_PATH"     : ".\\ResourcesConfigs\\Shape\\rock.png",
    "WATER_PATH"    : ".\\ResourcesConfigs\\Water\\water.png",
    "MAP": ["WWWWWWWWWWWWWWWWWWWWWWWWWWWWWW",
            "WWWWWWWWWWWWWWWWWWWWWWWWWWWWWW",
            "WWWWWWWWWWWWWWWWWWWWWWWWWWWWWW",
            "WWWWWWWWWWWWWWWWWWWWWWWWWWWWWW",
            "FFFFFFFFFFFFFFFFFFFFFFFFFFFFFF",
            "FFFFFFFFFFFFFFFFFFFFFFFFFFBBBB",
            "FFFFFFFFFFFFFFFFFFFFFFFFFFBWWW",
            "FFFFFFFFFFFFFFFFFFFFFFFFFFBWWW",
            "FFFFFFFFFFFFFFFFFFFFFFFFFFBBBB",
            "FFFFFBFFFFFFFFFFFFFFFFFFBFFFFF",
            "FFFFBBBFFFFFFFFFFFFFFFFBBBFFFF",
            "FFFFFBFFFFFFFFFFFFFFFFFFBFFFFF",
            "FFFFFFFFFFFFFFFFFFFFFFFFFFFFFF",
            "FFFFFFFFFFFFFFFFFFFFFFFFFFFFFF",
            "FFFFFFFFFFFFFFFFFFFFFFFFFFFFFF",
            "FFFFFFFFFFFFFFFFFFFFFFFFFFFFFF",
            "FFFFFFFFFFFFFFFFFFFFFFFFFFFFFF",
            "FFFFFFFFFFFFFFFFFFFFFFFFFFFFFF",
            "FFFFFFFFFFFFFFFFFFFFFFFFFFFFFF",
            "FFFFFFFFFFFFFFFFFFFFFFFFFFFFFF",
            "FFFFFFFFFFFFFFFFFFFFFFFFFFFFFF",
            "FFFFFBFFFFFFFFFFFFFFFFFFBFFFFF",
            "FFFFBBBFFFFFFFFFFFFFFFFBBBFFFF",
            "FFFFFBFFFFFFFFFFFFFFFFFFBFFFFF",
            "BFFFFFFFFFFFFFFFFFFFFFFFFFFFFF",
            "BFFFFFFFFFFFFFFFFFFFFFFFFFFFFB",
            "BFFFFFFFFFFFFFFFFFFFFFFFFFFFFB",
            "BFFFFFFFFFFFFFFFFFFFFFFFFFFFFB",
            "BBFFFFFFFFFFFFFFFFFFFFFFFFFFBB",
            "BBBBBBBBBBBBBBBBBBBBBBBBBBBBBB"]
}